111111111111111111111111111
10000000C00000011110111E011
100101111100000111001100111
10010000C0000P0000010100101
1001000000000C0111111100011
100C1111101100000C0000010C1
111111111111111111111111111